name=Room 2
instruction=
nextRoom=map_2.txt
monsters=monster_0.txt;monster_1.txt
+---------------------------+
|P|                         |
| |        +-------+        |
| |        |   K   |        |
| +---D----+ M   M |        |
|          D   M   |        |
| +--------+---K---+        |
| |           |+|           |
| |  M         M            |
| |     +-----------D       |
| |     |           |       |
| |    MD     M     |   M   |
|M+-----+           +-------+
|       |  M     M  |       |
|    K  |           |  M    |
+-------+----+E+----+-------+