name=Room 2
instruction=
nextRoom=
monsters=
+---------------+
|P              |
|               |
|               |
|              E|
+---------------+